....................
....................
....................
..##########........
....................
....................
....................
##############......
....................
....................
................####
..1.................
.........####.......
....................
....................
....###.......###...
....................
....................
####################