................................
................................
................................
................................
...............X................
.............#####..............
..1.............................
################################