...................................................................................................................................................................
...................................................................................................................................................................
...................................................................................................................................................................
...................................................................................................................................................................
...................................................................................................................................................................
...................................................................................................................................................................
...................................................................................................................................................................
...................................................................................................................................................................
...................................................................................................................................................................
...................................................................................................................................................................
..........................A........................................................................................................................................
1...........A.....HHHHHHHHHHH......................................................................................................................................
OOOOOOOOOOOOOO.....................................................................................................................................................
TTTTTTTTTTTTTT.....................................................................................................................................................
IIIIIIIIIIIIII.....................................................................................................................................................
IIIIIIIIIIIIII.....................................................................................................................................................
IIIIIIIIIIIIII.....................................................................................................................................................
IIIIIIIIIIIIII.....................................................................................................................................................
IIIIIIIIIIIIII.....................................................................................................................................................
IIIIIIIIIIIIII.....................................................................................................................................................
IIIIIIIIIIIIII.....................................................................................................................................................
IIIIIIIIIIIIII.....................................................................................................................................................
IIIIIIIIIIIIII.....................................................................................................................................................
IIIIIIIIIIIIII.....................................................................................................................................................
IIIIIIIIIIIIII.....................................................................................................................................................
IIIIIIIIIIIIII.....................................................................................................................................................
IIIIIIIIIIIIII.....................................................................................................................................................
IIIIIIIIIIIIII.....................................................................................................................................................
IIIIIIIIIIIIII.....................................................................................................................................................
IIIIIIIIIIIIII.....................................................................................................................................................
IIIIIIIIIIIIII.....................................................................................................................................................
IIIIIIIIIIIIII......................................................................................OOOOOOOOOOOOOOOOOOOOOOOOOOOOOOOOOOOOOOOOOOOOOOOOOOOOOOOOOOOOOOO
IIIIIIIIIIIIII......................................................................................TTTTTTTTTTTTTTTTTTTTTTTTTTTTTTTTTTTTTTTTTTTTTTTTTTTTTTTTTTTTTTT
IIIIIIIIIIIIII......................................................................................IIIIIIIIIIIIIIIIIIIIIIIIIIIIIIIIIIIIIIIIIIIIIIIIIIIIIIIIIIIIIII
IIIIIIIIIIIIII......................................................................................IIIIIIIIIIIIIIIIIIIIIIIIIIIIIIIIIIIIIIIIIIIIIIIIIIIIIIIIIIIIIII
IIIIIIIIIIIIII......................................................................................IIIIIIIIIIIIIIIIIIIIIIIIIIIIIIIIIIIIIIIIIIIIIIIIIIIIIIIIIIIIIII
IIIIIIIIIIIIII......................................................................................IIIIIIIIIIIIIIIIIIIIIIIIIIIIIIIIIIIIIIIIIIIIIIIIIIIIIIIIIIIIIII
IIIIIIIIIIIIII......................................................................................IIIIIIIIIIIIIIIIIIIIIIIIIIIIIIIIIIIIIIIIIIIIIIIIIIIIIIIIIIIIIII
IIIIIIIIIIIIII......................................................................................IIIIIIIIIIIIIIIIIIIIIIIIIIIIIIIIIIIIIIIIIIIIIIIIIIIIIIIIIIIIIII
IIIIIIIIIIIIII......................................................................................IIIIIIIIIIIIIIIIIIIIIIIIIIIIIIIIIIIIIIIIIIIIIIIIIIIIIIIIIIIIIII
IIIIIIIIIIIIII......................................................................................IIIIIIIIIIIIIIIIIIIIIIIIIIIIIIIIIIIIIIIIIIIIIIIIIIIIIIIIIIIIIII